# Map file for tile-based game
# (Lines that start with '#' are comments)
# The tiles are:
#   (Space) Empty tile
#   A..Z    Tiles A through Z
#   o       Star
#   !       Music Note
#   *       Goal
#   ^	    Health
#   a       Bad Guy a (grub)
#   b       Bad Guy b (fly)
#   c       Bad Guy c (monkey)
#   d	    Boss Guy 
#   0       Warp
                                                                 
                                                                 
AD                                                                      ^                      
AD                      + + +                I                   IIIIII  EBBBBBBBF c        +                       EF
AD c                   IIIIIII               I  c              b    b   bCAAAAAAAD    +                c            CD
AD                    b   !        b                                     CAAAAAAAAF        c                        CD
AD              a       IIIII                           IIIII      c     CAAAAAAAAHF   IIIIIII                      CD
AD         III                          a    a  a        b               CAAAAAAAAAD b           c          c     * CD
AD                            a      IIIIIIIIIIIII                       CAAAAAAAAAHF +                             CD
AD  c   a       EBBBF      c          + + + + + +          ccc           CAAAAAAAAAAD  ^o          bEBBBF   a  b  d CD
AHBBBBBBBBBBBBBBGAAAHBBBBBBBBBBBBBBBBBBBBBBBBBBBBBBBBBBBBBBBBBBBF      EBGAAAAAAAAAAHBBBBBBBBBBBBBBBGAAAHBBBBBBBBBBBGH